1111111111
1P00000CE111
10001111111111
111111
