111111
1P00C1
1CC001
100111
10C101
10CCE1
111111
