111111
10P0C1
1CC001
100111
10C101
10CCE1
111111
